{
	"_comments": ["I thought it would be more appropriate to use JSON rather than making our own",
				  "Each array in waves represents each wave.",
				  "Each level should have 24 waves",
				  "Idea. tile-type system."],
	"tutorial map 1": {
		"mapArray": [
			[2, 0, 0, 0, 0, 0, 0],
			[0, 1, 1, 1, 1, 1, 0],
			[0, 1, 0, 0, 0, 1, 0],
			[0, 1, 0, 1, 0, 1, 0],
			[0, 1, 0, 0, 0, 1, 0],
			[0, 1, 1, 1, 1, 1, 0],
			[0, 0, 0, 0, 0, 0, 3]
	],
		"waves": [
			[],
			[],
			[]
		]
	},
	"tutorial map 2": {
		"mapArray": [
			[2, 0, 0, 0, 0, 0, 0],
			[1, 1, 1, 1, 1, 1, 0],
			[0, 0, 0, 0, 0, 1, 0],
			[0, 1, 1, 1, 0, 1, 0],
			[0, 1, 3, 0, 0, 1, 0],
			[0, 1, 1, 1, 1, 1, 0],
			[0, 0, 0, 0, 0, 0, 0]
	],
		"waves": [
			[],
			[],
			[]
		]
	},



	"map1": {
		"mapArray": [
			[2, 0, 0, 0, 0, 0, 0, 0, 0, 0],
			[1, 1, 1, 1, 1, 1, 1, 1, 1, 0],
			[0, 0, 0, 0, 0, 0, 0, 0, 0, 0],
			[0, 1, 1, 1, 1, 1, 1, 1, 1, 1],
			[0, 0, 0, 0, 0, 0, 0, 0, 0, 0],
			[1, 1, 1, 1, 1, 1, 1, 1, 1, 0],
			[0, 0, 0, 0, 0, 0, 0, 0, 0, 0],
			[0, 1, 1, 1, 1, 1, 1, 1, 1, 1],
			[0, 0, 0, 0, 0, 0, 0, 0, 0, 0],
			[1, 1, 1, 1, 1, 1, 1, 1, 1, 3]
		],
		"waves": [
			[],
			[],
			[]
		]
	},
	"map2": {
		"mapArray": [
			[0, 0, 0, 0, 0, 0, 0, 0, 0, 2],
			[0, 1, 1, 1, 1, 1, 1, 1, 1, 1],
			[0, 0, 0, 0, 0, 0, 1, 0, 0, 0],
			[1, 1, 1, 1, 1, 0, 1, 0, 1, 0],
			[0, 0, 0, 0, 0, 0, 1, 0, 1, 0],
			[0, 1, 1, 1, 1, 1, 1, 0, 1, 0],
			[0, 0, 0, 0, 0, 0, 0, 0, 1, 0],
			[1, 1, 1, 1, 1, 1, 1, 1, 1, 0],
			[0, 0, 0, 0, 0, 0, 0, 0, 0, 0],
			[3, 1, 1, 1, 1, 1, 1, 1, 1, 1]
		],
		"waves": [
			[],
			[],
			[]
		]
	},
	"map3": {
		"mapArray": [
			[1, 2, 0, 0, 0, 1, 0, 0, 0, 0],
			[1, 1, 1, 1, 0, 1, 0, 1, 1, 0],
			[0, 0, 0, 1, 0, 1, 0, 1, 1, 0],
			[0, 1, 0, 1, 0, 0, 0, 1, 1, 0],
			[0, 1, 0, 1, 1, 1, 1, 1, 1, 0],
			[0, 1, 0, 1, 1, 1, 1, 1, 1, 0],
			[0, 1, 0, 0, 0, 0, 0, 0, 0, 0],
			[0, 1, 1, 1, 1, 1, 1, 1, 1, 1],
			[0, 0, 0, 0, 0, 0, 0, 0, 0, 3],
			[1, 1, 1, 1, 1, 1, 1, 1, 1, 1]
		],
		"waves": [
			[],
			[],
			[]
		]
	},	
	"map4": {
		"mapArray": [
			[0, 0, 0, 1, 1, 1, 1, 1, 1, 1, 1, 1, 1],
			[0, 1, 0, 1, 0, 0, 0, 0, 0, 0, 0, 0, 2],
			[0, 1, 0, 1, 0, 1, 1, 1, 1, 1, 1, 1, 1],
			[0, 1, 0, 1, 0, 0, 0, 0, 0, 0, 0, 0, 0],
			[0, 1, 0, 1, 0, 1, 1, 1, 1, 1, 1, 1, 0],
			[0, 1, 0, 0, 0, 0, 0, 0, 0, 0, 0, 1, 0],
			[0, 1, 0, 1, 1, 1, 1, 1, 1, 1, 0, 1, 0],
			[0, 1, 0, 0, 0, 0, 0, 0, 0, 0, 0, 1, 0],
			[0, 1, 1, 1, 1, 1, 0, 1, 1, 1, 1, 1, 0],
			[0, 1, 0, 0, 0, 0, 0, 0, 0, 0, 0, 0, 0],
			[0, 1, 0, 1, 1, 1, 1, 1, 1, 1, 1, 1, 0],
			[0, 0, 0, 0, 0, 0, 0, 0, 0, 0, 0, 0, 0],
			[3, 1, 1, 1, 1, 1, 1, 1, 1, 1, 1, 1, 1]
		],
		"waves": [
			[],
			[],
			[]
		]
	},
	"map5":{
	"mapArray": [
	[0, 0, 0, 0, 0, 0, 0, 0, 0, 0, 0, 0, 0],
	[2, 0, 1, 1, 1, 1, 1, 1, 1, 1, 1, 1, 0],
	[0, 0, 0, 0, 0, 0, 0, 0, 0, 0, 0, 0, 0],
	[0, 1, 1, 1, 1, 1, 1, 1, 1, 1, 1, 1, 0],
	[0, 0, 0, 0, 0, 0, 0, 0, 0, 0, 0, 0, 0],
	[0, 1, 1, 1, 1, 1, 0, 1, 0, 1, 0, 0, 0],
	[0, 1, 0, 0, 0, 1, 0, 1, 0, 1, 0, 0, 0],
	[0, 1, 0, 0, 0, 1, 0, 1, 0, 1, 0, 0, 0],
	[0, 1, 0, 0, 0, 1, 0, 1, 0, 1, 0, 0, 0],
	[0, 1, 0, 0, 0, 1, 0, 1, 0, 0, 0, 0, 0],
	[0, 1, 0, 0, 0, 1, 0, 0, 0, 1, 1, 1, 0],
	[0, 1, 1, 1, 1, 1, 1, 1, 0, 1, 0, 0, 0],
	[0, 0, 0, 0, 0, 0, 0, 0, 0, 0, 0, 0, 3]
],
	"waves":[
		[],
		[],
		[]
	]
}
}
