{
	"_comments": [  "Each array in waves represents each wave.",
			"Each level should have 24 waves",
			"Add your map ideas to https://github.com/Logi0/vilify/wiki/Map-Ideas"],
	"map1": {
		"mapArray": [
			[2, 0, 0, 0, 0, 0, 0, 0, 0, 1],
			[1, 1, 1, 1, 1, 1, 1, 1, 0, 1],
			[1, 0, 0, 0, 0, 0, 0, 1, 0, 1],
			[1, 0, 1, 1, 1, 1, 0, 1, 0, 1],
			[1, 0, 1, 0, 3, 1, 0, 1, 0, 1],
			[1, 0, 1, 0, 1, 1, 0, 1, 0, 1],
			[1, 0, 1, 0, 0, 0, 0, 1, 0, 1],
			[1, 0, 1, 1, 1, 1, 1, 1, 0, 1],
			[1, 0, 0, 0, 0, 0, 0, 0, 0, 1],
			[1, 1, 1, 1, 1, 1, 1, 1, 1, 1]
			],
		"waves": [
			[1, 1, 1, 1, 1, 1, 1],
			[1, 1, 1, 1, 1, 1, 1],
			[1, 1, 1, 1, 1, 1, 1]
		]
	},
	"map2": {
		"mapArray": [
			[2, 0, 0, 0, 0, 0, 0, 0, 0, 0],
			[1, 1, 1, 1, 1, 1, 1, 1, 1, 0],
			[0, 0, 0, 0, 0, 0, 0, 0, 0, 0],
			[0, 1, 1, 1, 1, 1, 1, 1, 1, 1],
			[0, 0, 0, 0, 1, 0, 0, 0, 0, 0],
			[1, 1, 1, 0, 1, 0, 1, 1, 1, 0],
			[0, 0, 0, 0, 1, 0, 1, 3, 1, 0],
			[0, 1, 1, 1, 1, 0, 1, 0, 1, 0],
			[0, 0, 0, 0, 0, 0, 1, 0, 1, 0],
			[1, 1, 1, 1, 1, 1, 1, 0, 0, 0]
		],
		"waves": [
			[1, 1, 1, 1, 1, 1, 1, 1, 1],
			[1, 1, 2, 1, 2, 1, 1, 1, 2],
			[2, 1, 2, 2, 1, 2, 1, 2, 1],
			[1, 1, 2, 2, 1, 2, 1, 1, 2]
		]
	}
}
